Team,Pass Att,Cmp,Cmp %,Yds/Att,Pass Yds,Pass TD,INT,Rush Att,Rush Yds,Yds/Crry,Rush TD,Total Yds,Total TD,Year
Commanders,636,407,64,6.6,4174,24,21,359,1592,4.4,14,5766,38,2023
Chiefs,635,421,66.3,6.9,4383,28,17,417,1784,4.3,9,6167,37,2023
Chargers,632,409,64.7,6.8,4312,24,8,431,1642,3.8,11,5954,35,2023
Vikings,631,424,67.2,7.4,4700,30,19,393,1553,4,7,6253,37,2023
Browns,624,355,56.9,6.4,4011,24,23,518,2017,3.9,15,6028,39,2023
Jaguars,620,412,66.4,7.1,4377,22,14,453,1646,3.6,17,6023,39,2023
Bengals,615,420,68.3,6.9,4257,27,14,383,1527,4,12,5784,39,2023
Cowboys,614,428,69.7,7.6,4660,36,10,468,1920,4.1,14,6580,50,2023
Lions,606,408,67.3,7.6,4606,30,12,500,2311,4.6,27,6917,57,2023
Saints,606,406,67,7,4225,28,11,480,1742,3.6,13,5967,41,2023
Jets,601,356,59.2,5.6,3373,11,15,388,1647,4.2,7,5020,18,2023
Texans,592,372,62.8,7.7,4578,27,8,444,1647,3.7,10,6225,37,2023
Panthers,586,350,59.7,5.5,3245,13,10,445,1769,4,7,5014,20,2023
Rams,583,361,61.9,7.4,4300,26,13,477,2045,4.3,18,6345,44,2023
Packers,581,374,64.4,7.2,4210,32,11,441,1905,4.3,10,6115,42,2023
Bills,579,385,66.5,7.4,4306,29,18,512,2212,4.3,22,6518,51,2023
Seahawks,575,371,64.5,7.2,4167,23,12,382,1580,4.1,11,5747,34,2023
Colts,574,355,61.8,6.8,3882,18,10,479,2059,4.3,19,5941,37,2023
Buccaneers,568,364,64.1,7.1,4044,28,10,439,1509,3.4,8,5553,36,2023
Dolphins,566,393,69.4,8.3,4698,30,15,456,2308,5.1,27,7006,57,2023
Eagles,563,369,65.5,7.2,4067,24,16,510,2190,4.3,22,6257,46,2023
Raiders,557,348,62.5,6.6,3666,20,18,413,1542,3.7,11,5208,31,2023
Patriots,557,351,63,6.1,3392,16,21,415,1627,3.9,9,5019,25,2023
Cardinals,555,355,64,6.2,3430,18,12,471,2365,5,17,5795,35,2023
Falcons,530,327,61.7,7.1,3775,17,17,522,2159,4.1,14,5934,31,2023
Giants,518,338,65.2,6.5,3351,15,12,454,1874,4.1,10,5225,25,2023
Bears,513,321,62.6,6.7,3421,19,15,534,2399,4.5,16,5820,35,2023
Broncos,513,337,65.7,7,3566,28,9,451,1810,4,8,5376,36,2023
Steelers,506,323,63.8,6.8,3421,13,9,487,2010,4.1,16,5431,29,2023
Ravens,494,328,66.4,7.9,3881,27,7,541,2661,4.9,26,6542,53,2023
Titans,494,304,61.5,7.1,3512,14,11,444,1846,4.2,16,5358,30,2023
49ers,491,336,68.4,9.3,4577,33,12,499,2389,4.8,27,6966,60,2023
Buccaneers,751,499,66.4,6.3,4746,26,10,386,1308,3.4,5,6054,31,2022
Chargers,711,485,68.2,6.7,4791,26,10,404,1524,3.8,15,6315,41,2022
Vikings,672,448,66.7,7.2,4818,30,15,404,1661,4.1,18,6479,48,2022
Cardinals,664,433,65.2,6,3966,17,17,434,1873,4.3,15,5839,32,2022
Chiefs,651,435,66.8,8.1,5250,41,12,417,1970,4.7,18,7220,59,2022
Jets,627,357,56.9,6.4,4040,15,14,405,1686,4.2,13,5726,28,2022
Bengals,610,418,68.5,7.4,4520,35,12,399,1528,3.8,14,6048,49,2022
Colts,604,398,65.9,6.4,3854,17,20,439,1866,4.2,8,5720,25,2022
Jaguars,596,394,66.1,7,4148,25,9,448,2116,4.7,16,6264,41,2022
Lions,588,383,65.1,7.6,4444,29,7,480,2179,4.5,23,6623,52,2022
Raiders,586,359,61.3,7.1,4182,28,17,428,2059,4.8,12,6241,40,2022
Dolphins,584,368,63,8.2,4765,30,15,390,1686,4.3,12,6451,42,2022
Texans,579,352,60.8,6.3,3642,20,19,398,1476,3.7,7,5118,27,2022
Bills,574,361,62.9,7.5,4291,35,14,430,2232,5.2,15,6523,50,2022
Seahawks,573,399,69.6,7.5,4282,30,12,425,2042,4.8,12,6324,42,2022
Broncos,571,345,60.4,7,4007,18,15,444,1935,4.4,11,5942,29,2022
Steelers,571,364,63.8,6.4,3661,12,14,500,2073,4.2,16,5734,28,2022
Packers,563,364,64.6,6.9,3890,27,12,456,2113,4.6,12,6003,39,2022
Cowboys,556,355,63.8,7,3911,28,18,531,2298,4.3,24,6209,52,2022
Commanders,554,344,62.1,6.8,3783,24,16,538,2143,4,9,5926,33,2022
Browns,540,335,62,6.9,3710,19,12,532,2490,4.7,19,6200,38,2022
Patriots,540,358,66.3,7.1,3815,19,14,425,1812,4.3,12,5627,31,2022
Eagles,536,350,65.3,8.1,4364,25,9,544,2509,4.6,32,6873,57,2022
Rams,531,347,65.4,6.6,3506,16,15,411,1661,4,15,5167,31,2022
Giants,520,346,66.5,6.6,3431,17,6,520,2519,4.8,21,5950,38,2022
Saints,512,338,66,7.8,3969,24,14,465,1982,4.3,12,5951,36,2022
49ers,512,338,66,7.9,4049,30,9,504,2360,4.7,20,6409,50,2022
Ravens,488,300,61.5,6.6,3202,19,13,526,2720,5.2,14,5922,33,2022
Panthers,457,267,58.4,7.1,3246,16,13,483,2210,4.6,16,5456,32,2022
Titans,456,285,62.5,7.1,3227,16,11,487,2131,4.4,16,5358,32,2022
Falcons,415,257,61.9,7,2927,17,9,559,2718,4.9,17,5645,34,2022
Bears,377,223,59.2,6.9,2598,19,15,558,3014,5.4,18,5612,37,2022
Buccaneers,731,492,67.3,7.4,5383,43,12,385,1672,4.3,18,7055,61,2021
Chiefs,675,448,66.4,7.3,4937,37,13,431,1955,4.5,16,6892,53,2021
Chargers,674,443,65.7,7.4,5014,38,15,423,1834,4.3,18,6848,56,2021
Steelers,664,425,64,6,4017,23,11,411,1583,3.8,10,5600,33,2021
Bills,655,415,63.4,6.8,4450,36,16,461,2209,4.8,20,6659,56,2021
Cowboys,647,444,68.6,7.7,4963,40,11,473,2119,4.5,15,7082,55,2021
Raiders,628,429,68.3,7.7,4808,23,14,414,1617,3.9,14,6425,37,2021
Dolphins,615,404,65.7,6.4,3936,21,14,442,1568,3.6,12,5504,33,2021
Ravens,611,396,64.8,7,4267,21,18,517,2479,4.8,18,6746,39,2021
Rams,607,406,66.9,8.1,4893,41,18,420,1683,4,10,6576,51,2021
Jaguars,604,361,59.8,6.1,3674,12,17,392,1755,4.5,13,5429,25,2021
Vikings,604,398,65.9,7.4,4450,34,7,449,1930,4.3,10,6380,44,2021
Jets,603,357,59.2,6.6,3959,20,20,380,1667,4.4,14,5626,34,2021
Panthers,599,348,58.1,6,3573,14,21,455,1842,4,17,5415,31,2021
Lions,593,396,66.8,6.6,3884,23,14,427,1886,4.4,12,5770,35,2021
Packers,593,402,67.8,7.6,4526,39,7,446,1900,4.3,13,6426,52,2021
Giants,593,351,59.2,5.8,3463,15,20,419,1688,4,8,5151,23,2021
Cardinals,591,415,70.2,7.8,4619,27,11,496,2076,4.2,23,6695,50,2021
Falcons,573,377,65.8,7,3987,20,15,393,1451,3.7,11,5438,31,2021
Bengals,555,384,69.2,8.7,4806,36,14,436,1742,4,16,6548,52,2021
Football Team,550,356,64.7,6.8,3746,21,15,477,2061,4.3,13,5807,34,2021
Texans,546,354,64.8,6.6,3630,21,15,420,1422,3.4,8,5052,29,2021
Bears,542,332,61.2,6.7,3635,16,20,475,2018,4.2,14,5653,30,2021
Broncos,541,354,65.4,7.1,3856,20,9,455,2025,4.4,16,5881,36,2021
Titans,535,359,67.1,7,3745,22,14,551,2404,4.4,23,6149,45,2021
Patriots,535,364,68,7.7,4098,24,13,489,2151,4.4,24,6249,48,2021
Colts,521,324,62.2,6.9,3588,27,8,499,2540,5.1,22,6128,49,2021
Browns,520,320,61.5,7,3619,21,14,485,2471,5.1,20,6090,41,2021
49ers,514,343,66.7,8.6,4437,26,14,499,2166,4.3,22,6603,48,2021
Saints,504,293,58.1,6.8,3437,29,13,510,1991,3.9,12,5428,41,2021
Seahawks,495,324,65.4,7.7,3815,30,7,413,2074,5,18,5889,48,2021
Eagles,494,307,62.2,7.3,3585,20,10,550,2715,4.9,25,6300,45,2021
Steelers,656,428,65.2,6.3,4129,35,11,373,1351,3.6,12,5480,47,2020
Cowboys,639,413,64.6,7.1,4511,25,13,430,1788,4.2,14,6299,39,2020
Chiefs,630,420,66.7,7.9,5005,40,7,403,1799,4.5,13,6804,53,2020
Falcons,628,408,65,7.4,4620,27,11,409,1532,3.8,13,6152,40,2020
Chargers,627,413,65.9,7.2,4548,31,10,466,1784,3.8,12,6332,43,2020
Buccaneers,626,410,65.5,7.6,4776,42,12,369,1519,4.1,16,6295,58,2020
Jaguars,616,387,62.8,6.4,3955,25,16,337,1519,4.5,9,5474,34,2020
Bears,614,402,65.5,6.4,3925,26,16,393,1647,4.2,12,5572,38,2020
Football Team,601,389,64.7,6.3,3796,16,16,400,1611,4,18,5407,34,2020
Eagles,598,334,55.8,6.2,3728,22,20,403,2027,5,16,5755,38,2020
Bills,596,410,68.8,8,4786,40,11,411,1723,4.2,16,6509,56,2020
Rams,590,392,66.4,7.1,4183,20,14,473,2018,4.3,19,6201,39,2020
Lions,582,374,64.3,7.6,4397,27,13,367,1499,4.1,17,5896,44,2020
Bengals,581,372,64,6.5,3793,19,11,411,1668,4.1,13,5461,32,2020
Cardinals,575,387,67.3,7.1,4102,27,13,479,2237,4.7,22,6339,49,2020
49ers,570,371,65.1,7.6,4320,25,17,437,1889,4.3,19,6209,44,2020
Seahawks,563,388,68.9,7.5,4245,40,13,411,1971,4.8,15,6216,55,2020
Dolphins,559,370,66.2,7,3937,24,13,428,1688,3.9,15,5625,39,2020
Broncos,556,317,57,6.6,3673,21,23,442,1918,4.3,13,5591,34,2020
Colts,552,371,67.2,7.6,4186,24,11,459,1996,4.4,20,6182,44,2020
Raiders,551,369,67,8,4383,28,10,457,1916,4.2,20,6299,48,2020
Panthers,550,373,67.8,7.5,4129,16,16,407,1704,4.2,19,5833,35,2020
Texans,546,383,70.2,8.9,4843,33,7,344,1466,4.3,10,6309,43,2020
Packers,526,372,70.7,8.2,4299,48,5,443,2118,4.8,16,6417,64,2020
Saints,522,370,70.9,7.6,3945,28,8,494,2265,4.6,30,6210,58,2020
Giants,517,321,62.1,6.4,3336,12,11,399,1768,4.4,13,5104,25,2020
Vikings,516,349,67.6,8.3,4265,35,13,468,2283,4.9,20,6548,55,2020
Browns,501,315,62.9,7.4,3701,27,8,495,2374,4.8,21,6075,48,2020
Jets,499,292,58.5,6.2,3115,16,14,406,1683,4.2,9,4798,25,2020
Titans,485,316,65.2,7.9,3826,33,7,521,2690,5.2,26,6516,59,2020
Patriots,440,283,64.3,7.1,3124,12,14,502,2346,4.7,20,5470,32,2020
Ravens,406,257,63.3,7.2,2919,27,11,555,3071,5.5,24,5990,51,2020
Falcons,684,459,67.1,7.4,5049,29,15,362,1361,3.8,10,6410,39,2019
Panthers,633,382,60.4,6.5,4134,17,21,386,1819,4.7,20,5953,37,2019
Rams,632,397,62.8,7.4,4669,22,17,401,1499,3.7,20,6168,42,2019
Buccaneers,630,382,60.6,8.1,5127,33,30,409,1521,3.7,15,6648,48,2019
Patriots,620,378,61,6.7,4153,25,9,447,1703,3.8,17,5856,42,2019
Bengals,616,356,57.8,6.5,3994,18,16,385,1517,3.9,9,5511,27,2019
Dolphins,615,371,60.3,6.7,4117,22,18,349,1156,3.3,10,5273,32,2019
Eagles,613,391,63.8,6.6,4063,27,8,454,1939,4.3,16,6002,43,2019
Giants,607,376,61.9,6.7,4070,30,17,362,1685,4.6,11,5755,41,2019
Cowboys,597,388,65,8.2,4902,30,11,449,2153,4.8,18,7055,48,2019
Chargers,597,394,66,7.8,4648,24,20,366,1453,4,12,6101,36,2019
Jaguars,589,364,61.8,6.8,4023,24,8,389,1708,4.4,3,5731,27,2019
Saints,581,418,71.9,7.6,4431,36,6,405,1738,4.3,12,6169,48,2019
Bears,580,371,64,6.2,3573,20,12,395,1458,3.7,8,5031,28,2019
Chiefs,576,378,65.6,8.1,4690,30,5,375,1569,4.2,16,6259,46,2019
Packers,573,356,62.1,7,4017,26,4,411,1795,4.4,18,5812,44,2019
Lions,571,344,60.2,7.3,4187,28,15,407,1649,4,7,5836,35,2019
Cardinals,554,355,64.1,6.8,3797,20,12,396,1990,5,18,5787,38,2019
Browns,539,318,59,7.1,3847,22,21,393,1901,4.8,15,5748,37,2019
Texans,534,355,66.5,7.6,4083,27,14,434,2009,4.6,17,6092,44,2019
Raiders,523,367,70.2,7.9,4110,22,8,437,1893,4.3,13,6003,35,2019
Jets,521,323,62,6.6,3443,19,16,383,1257,3.3,6,4700,25,2019
Seahawks,517,341,66,8,4110,31,6,481,2200,4.6,15,6310,46,2019
Bills,513,299,58.3,6.8,3476,21,12,465,2054,4.4,13,5530,34,2019
Colts,513,307,59.8,6.5,3314,22,10,471,2130,4.5,17,5444,39,2019
Steelers,510,315,61.8,6.3,3214,18,19,395,1447,3.7,7,4661,25,2019
Broncos,504,312,61.9,6.8,3401,16,10,409,1662,4.1,11,5063,27,2019
Redskins,479,298,62.2,6.7,3205,18,13,356,1583,4.4,9,4788,27,2019
49ers,478,331,69.2,8.4,4029,28,13,498,2305,4.6,23,6334,51,2019
Vikings,466,319,68.4,8,3729,26,8,476,2133,4.5,19,5862,45,2019
Titans,448,297,66.3,8.8,3956,29,8,445,2223,5,21,6179,50,2019
Ravens,440,289,65.7,7.6,3350,37,8,596,3296,5.5,21,6646,58,2019
Steelers,689,459,66.6,7.5,5174,35,17,345,1445,4.2,16,6619,51,2018
Colts,644,432,67.1,7.1,4595,39,15,408,1718,4.2,13,6313,52,2018
Packers,640,392,61.2,7.2,4629,25,4,333,1667,5,14,6296,39,2018
Buccaneers,625,408,65.3,8.6,5358,36,26,389,1523,3.9,11,6881,47,2018
Falcons,617,428,69.4,8,4949,36,7,351,1573,4.5,11,6522,47,2018
Vikings,606,425,70.1,7.1,4298,30,10,357,1493,4.2,9,5791,39,2018
Eagles,599,422,70.4,7.6,4524,29,11,398,1570,3.9,12,6094,41,2018
Broncos,588,367,62.4,6.7,3930,19,15,393,1907,4.8,18,5837,37,2018
Chiefs,583,385,66,8.8,5126,50,12,387,1855,4.8,16,6981,66,2018
Giants,583,382,65.5,7.6,4405,23,12,354,1650,4.7,13,6055,36,2018
Browns,574,353,61.5,7.4,4261,29,17,411,1893,4.6,15,6154,44,2018
Lions,574,375,65.3,6.7,3844,22,12,404,1660,4.1,11,5504,33,2018
Patriots,574,378,65.8,7.7,4405,29,11,478,2037,4.3,18,6442,47,2018
Rams,568,368,64.8,8.3,4730,32,12,459,2231,4.9,23,6961,55,2018
Panthers,563,378,67.1,7.2,4071,28,16,416,2136,5.1,17,6207,45,2018
Ravens,556,334,60.1,6.7,3708,18,9,547,2441,4.5,19,6149,37,2018
Raiders,556,382,68.7,7.3,4057,19,10,387,1628,4.2,9,5685,28,2018
Bengals,542,331,61.1,6.6,3569,27,13,359,1682,4.7,13,5251,40,2018
Jaguars,536,329,61.4,6.4,3431,15,13,416,1723,4.1,7,5154,22,2018
49ers,532,331,62.2,8,4247,26,20,423,1902,4.5,7,6149,33,2018
Cowboys,527,356,67.6,7.4,3885,22,8,439,1963,4.5,13,5848,35,2018
Jets,524,299,57.1,6.5,3404,18,19,410,1622,4,11,5026,29,2018
Saints,519,381,73.4,8,4174,33,7,471,2025,4.3,26,6199,59,2018
Bears,512,344,67.2,7.3,3747,28,14,468,1938,4.1,16,5685,44,2018
Chargers,512,348,68,8.4,4316,32,12,399,1873,4.7,16,6189,48,2018
Redskins,509,311,61.1,6.5,3287,16,15,414,1774,4.3,12,5061,28,2018
Texans,506,345,68.2,8.2,4165,26,9,472,2021,4.3,12,6186,38,2018
Bills,499,271,54.3,6.2,3082,13,23,468,1984,4.2,15,5066,28,2018
Cardinals,495,283,57.2,5.8,2884,15,18,355,1342,3.8,9,4226,24,2018
Dolphins,455,292,64.2,7.3,3309,26,13,371,1738,4.7,7,5047,33,2018
Titans,437,293,67,7.4,3255,16,12,454,2023,4.5,15,5278,31,2018
Seahawks,427,280,65.6,8.1,3448,35,7,534,2560,4.8,15,6008,50,2018
Giants,608,373,61.4,6,3680,20,14,394,1549,3.9,6,5229,26,2017
49ers,607,362,59.6,7,4235,15,15,408,1662,4.1,15,5897,30,2017
Buccaneers,605,378,62.5,7.6,4607,26,14,389,1450,3.7,8,6057,34,2017
Dolphins,602,373,62,6.3,3792,24,21,360,1388,3.9,4,5180,28,2017
Cardinals,598,339,56.7,6.6,3979,21,18,409,1386,3.4,6,5365,27,2017
Steelers,590,384,65.1,7.7,4534,29,15,437,1667,3.8,12,6201,41,2017
Patriots,587,389,66.3,7.9,4619,32,8,448,1889,4.2,16,6508,48,2017
Chargers,583,366,62.8,7.8,4551,28,11,419,1595,3.8,10,6146,38,2017
Browns,574,312,54.4,6.2,3537,15,28,384,1714,4.5,11,5251,26,2017
Lions,570,374,65.6,7.8,4470,29,11,363,1221,3.4,10,5691,39,2017
Ravens,567,363,64,5.7,3235,20,13,460,1856,4,14,5091,34,2017
Broncos,566,332,58.7,6.5,3668,19,22,457,1852,4,8,5520,27,2017
Eagles,564,341,60.5,7,3967,38,9,473,2115,4.5,9,6082,47,2017
Packers,562,352,62.6,6.3,3532,25,18,386,1724,4.5,13,5256,38,2017
Raiders,558,347,62.2,6.7,3761,23,14,370,1554,4.2,13,5315,36,2017
Seahawks,555,340,61.3,7.2,3979,34,12,409,1629,4,4,5608,38,2017
Chiefs,543,363,66.8,8,4326,26,8,405,1903,4.7,12,6229,38,2017
Redskins,540,347,64.3,7.6,4093,27,13,401,1448,3.6,10,5541,37,2017
Saints,536,386,72,8.1,4334,23,8,444,2070,4.7,23,6404,46,2017
Falcons,530,343,64.7,7.8,4146,21,12,430,1847,4.3,12,5993,33,2017
Jaguars,527,316,60,7,3716,21,13,527,2262,4.3,18,5978,39,2017
Vikings,527,357,67.7,7.5,3929,25,8,501,1957,3.9,15,5886,40,2017
Texans,525,299,57,6.9,3644,28,17,448,1842,4.1,8,5486,36,2017
Rams,518,320,61.8,7.8,4023,28,7,454,1953,4.3,17,5976,45,2017
Bengals,510,304,59.6,6.6,3386,25,12,377,1366,3.6,6,4752,31,2017
Jets,510,323,63.3,6.9,3501,19,12,427,1702,4,13,5203,32,2017
Panthers,501,293,58.5,6.6,3319,22,16,490,2102,4.3,15,5421,37,2017
Titans,496,306,61.7,6.8,3394,14,17,443,1833,4.1,18,5227,32,2017
Cowboys,493,309,62.7,6.8,3326,22,13,480,2170,4.5,18,5496,40,2017
Colts,487,285,58.5,6.6,3226,13,9,451,1661,3.7,11,4887,24,2017
Bills,476,289,60.7,6.5,3086,16,10,487,2017,4.1,12,5103,28,2017
Bears,473,291,61.5,6.5,3085,13,12,422,1788,4.2,13,4873,26,2017
Ravens,679,439,64.6,6.4,4343,20,16,367,1463,4,10,5806,30,2016
Saints,674,472,70,7.8,5258,38,15,404,1742,4.3,17,7000,55,2016
Cardinals,646,383,59.3,6.8,4425,28,17,399,1732,4.3,20,6157,48,2016
Jaguars,626,369,59,6.3,3925,24,16,392,1631,4.2,8,5556,32,2016
Packers,620,403,65,7.2,4445,40,8,374,1701,4.6,11,6146,51,2016
Eagles,609,380,62.4,6.2,3798,16,14,438,1813,4.1,16,5611,32,2016
Redskins,607,407,67,8.2,4948,25,12,379,1696,4.5,17,6644,42,2016
Giants,598,377,63,6.7,4027,26,16,398,1412,3.6,6,5439,32,2016
Raiders,596,379,63.6,6.9,4137,29,7,434,1922,4.4,17,6059,46,2016
Steelers,596,381,63.9,7.3,4377,33,15,409,1760,4.3,13,6137,46,2016
Lions,594,388,65.3,7.3,4327,24,10,350,1310,3.7,9,5637,33,2016
Vikings,588,414,70.4,7,4119,20,5,380,1205,3.2,9,5324,29,2016
Colts,584,370,63.4,7.7,4491,32,15,409,1628,4,13,6119,45,2016
Texans,583,347,59.5,5.9,3418,15,16,456,1859,4.1,8,5277,23,2016
Chargers,580,349,60.2,7.6,4386,33,21,398,1510,3.8,10,5896,43,2016
Buccaneers,578,355,61.4,7.2,4165,29,18,453,1616,3.6,8,5781,37,2016
Broncos,570,339,59.5,6.9,3914,20,11,410,1484,3.6,11,5398,31,2016
Browns,567,338,59.6,6.5,3693,15,14,350,1712,4.9,13,5405,28,2016
Seahawks,567,368,64.9,7.8,4422,23,12,403,1591,4,13,6013,36,2016
Panthers,563,306,54.4,7,3962,21,19,453,1814,4,16,5776,37,2016
Bengals,563,364,64.6,7.5,4206,18,8,446,1769,4,17,5975,35,2016
Bears,559,347,62.1,7.4,4139,19,19,380,1735,4.6,10,5874,29,2016
Patriots,550,368,66.9,8.1,4456,32,2,482,1872,3.9,19,6328,51,2016
Jets,550,311,56.6,6.6,3645,16,25,418,1802,4.3,10,5447,26,2016
Chiefs,546,365,66.8,7.2,3914,19,8,412,1748,4.2,15,5662,34,2016
Falcons,537,374,69.6,9.2,4960,38,7,421,1928,4.6,20,6888,58,2016
Rams,536,312,58.2,6.2,3313,14,20,375,1252,3.3,9,4565,23,2016
Titans,504,307,60.9,7.4,3720,29,11,476,2187,4.6,16,5907,45,2016
49ers,491,287,58.4,6.4,3166,21,10,458,2019,4.4,15,5185,36,2016
Cowboys,483,325,67.3,7.9,3799,25,6,499,2396,4.8,24,6195,49,2016
Dolphins,477,316,66.2,7.8,3716,27,15,405,1824,4.5,14,5540,41,2016
Bills,474,286,60.3,6.9,3250,17,7,492,2630,5.4,29,5880,46,2016
Ravens,676,426,63,6.6,4449,21,21,383,1478,3.9,8,5927,29,2015
Saints,667,460,69,7.8,5205,32,12,397,1491,3.8,16,6696,48,2015
Chargers,667,442,66.3,7.3,4855,30,13,393,1358,3.5,4,6213,34,2015
Lions,632,420,66.5,7.1,4463,33,14,354,1335,3.8,7,5798,40,2015
Patriots,629,404,64.2,7.6,4812,36,7,383,1404,3.7,14,6216,50,2015
Giants,623,392,62.9,7.2,4500,36,14,403,1609,4,5,6109,41,2015
Eagles,623,405,65,7,4341,23,18,442,1743,3.9,15,6084,38,2015
Falcons,621,410,66,7.4,4602,21,17,420,1606,3.8,13,6208,34,2015
Texans,619,358,57.8,6.6,4079,29,12,472,1731,3.7,7,5810,36,2015
Colts,619,355,57.4,6.4,3928,26,19,396,1438,3.6,6,5366,32,2015
Browns,609,371,60.9,6.8,4156,20,12,380,1529,4,5,5685,25,2015
Jaguars,607,355,58.5,7.3,4428,35,18,354,1473,4.2,5,5901,40,2015
Broncos,606,368,60.7,7,4216,19,23,411,1718,4.2,13,5934,32,2015
Raiders,605,373,61.6,6.8,4129,34,14,370,1457,3.9,7,5586,41,2015
Jets,604,362,59.9,6.9,4170,33,16,448,1868,4.2,11,6038,44,2015
Steelers,590,391,66.3,8.2,4822,26,21,388,1724,4.4,16,6546,42,2015
Dolphins,588,365,62.1,7.2,4231,24,12,344,1496,4.4,11,5727,35,2015
Packers,573,348,60.7,6.7,3825,31,8,436,1850,4.2,8,5675,39,2015
Cardinals,562,353,62.8,8.5,4775,35,13,452,1917,4.2,16,6692,51,2015
Redskins,555,386,69.6,7.7,4294,30,11,429,1566,3.6,9,5860,39,2015
Titans,551,342,62.1,7.1,3893,25,17,371,1485,4,10,5378,35,2015
Buccaneers,535,312,58.3,7.6,4042,22,15,455,2162,4.8,12,6204,34,2015
Cowboys,528,334,63.3,7,3677,16,22,408,1890,4.6,8,5567,24,2015
Niners,526,322,61.2,6.9,3646,16,12,390,1544,4,7,5190,23,2015
Bears,523,334,63.9,7.4,3843,21,12,468,1854,4,13,5697,34,2015
Bengals,505,334,66.1,8.1,4104,31,9,467,1805,3.9,18,5909,49,2015
Panthers,501,300,59.9,7.7,3873,35,10,526,2282,4.3,19,6155,54,2015
Seahawks,489,333,68.1,8.3,4061,34,8,500,2268,4.5,10,6329,44,2015
Chiefs,473,310,65.5,7.4,3493,20,7,436,2044,4.7,19,5537,39,2015
Rams,473,273,57.7,6.2,2931,11,11,429,1956,4.6,16,4887,27,2015
Bills,465,295,63.4,7.7,3600,23,9,509,2432,4.8,19,6032,42,2015
Vikings,454,294,64.8,7.2,3246,14,9,474,2211,4.7,18,5457,32,2015
Colts,661,410,62,7.7,5062,42,16,415,1612,3.9,9,6674,51,2014
Saints,659,456,69.2,7.5,4952,33,17,406,1818,4.5,16,6770,49,2014
Falcons,632,418,66.1,7.5,4758,28,15,372,1498,4,11,6256,39,2014
Raiders,629,365,58,5.5,3456,22,16,337,1240,3.7,4,4696,26,2014
Eagles,621,384,61.8,7.4,4581,27,21,474,1992,4.2,16,6573,43,2014
Steelers,612,411,67.2,8.2,4997,33,10,423,1752,4.1,10,6749,43,2014
Bears,609,396,65,6.6,4035,30,19,355,1441,4.1,8,5476,38,2014
Patriots,609,392,64.4,7,4291,34,9,438,1727,3.9,13,6018,47,2014
Broncos,607,399,65.7,7.9,4779,40,15,443,1785,4,15,6564,55,2014
Giants,607,383,63.1,7.4,4470,30,14,449,1603,3.6,13,6073,43,2014
Lions,604,365,60.4,7.1,4284,22,12,396,1422,3.6,11,5706,33,2014
Dolphins,595,394,66.2,6.8,4066,27,12,399,1872,4.7,12,5938,39,2014
Bills,579,363,62.7,6.7,3856,23,13,402,1482,3.7,7,5338,30,2014
Chargers,574,380,66.2,7.5,4296,31,18,398,1367,3.4,6,5663,37,2014
Cardinals,568,320,56.3,7,3990,21,12,397,1308,3.3,6,5298,27,2014
Jaguars,557,325,58.4,6.2,3451,15,18,360,1633,4.5,9,5084,24,2014
Ravens,554,344,62.1,7.2,3986,27,12,448,2019,4.5,16,6005,43,2014
Redskins,547,364,66.5,8.2,4461,18,18,401,1691,4.2,15,6152,33,2014
Panthers,545,327,60,7,3828,23,12,473,2036,4.3,10,5864,33,2014
Packers,536,349,65.1,8.3,4447,38,6,435,1917,4.4,14,6364,52,2014
Buccaneers,531,301,56.7,6.8,3623,21,20,353,1375,3.9,7,4998,28,2014
Vikings,517,322,62.3,6.9,3566,17,18,413,1804,4.4,12,5370,29,2014
Rams,515,327,63.5,7.2,3695,20,16,395,1635,4.1,11,5330,31,2014
Titans,513,299,58.3,7.3,3738,20,16,356,1447,4.1,6,5185,26,2014
Bengals,503,323,64.2,7.1,3551,20,17,492,2147,4.4,19,5698,39,2014
Browns,502,274,54.6,7.3,3678,12,16,477,1728,3.6,17,5406,29,2014
Jets,498,287,57.6,6.4,3206,16,15,507,2280,4.5,11,5486,27,2014
Chiefs,493,320,64.9,7,3428,18,6,420,1918,4.6,18,5346,36,2014
Niners,487,292,60,7,3407,20,10,470,2176,4.6,10,5583,30,2014
Texans,485,295,60.8,7.1,3460,22,13,551,2161,3.9,12,5621,34,2014
Cowboys,476,328,68.9,8.4,4008,37,11,508,2354,4.6,16,6362,53,2014
Seahawks,454,287,63.2,7.7,3492,20,7,525,2762,5.3,20,6254,40,2014
Browns,681,379,55.6,6.4,4372,26,20,348,1383,4,4,5755,30,2013
Broncos,675,461,68.3,8.2,5572,55,10,461,1873,4.1,16,7445,71,2013
Falcons,659,445,67.5,6.9,4541,26,17,321,1247,3.9,11,5788,37,2013
Saints,651,446,68.5,7.9,5162,39,12,391,1473,3.8,10,6635,49,2013
Lions,634,371,58.5,7.3,4650,29,19,445,1792,4,15,6442,44,2013
Texans,633,371,58.6,6.6,4183,19,22,414,1743,4.2,7,5926,26,2013
Patriots,628,380,60.5,6.9,4343,25,11,470,2065,4.4,19,6408,44,2013
Ravens,619,363,58.6,6.3,3914,19,23,423,1328,3.1,7,5242,26,2013
Redskins,611,355,58.1,6.6,4057,20,19,453,2164,4.8,14,6221,34,2013
Dolphins,594,357,60.1,6.7,3966,24,19,349,1440,4.1,8,5406,32,2013
Jaguars,592,349,59,6.3,3751,16,21,378,1260,3.3,7,5011,23,2013
Bengals,587,364,62,7.4,4318,33,20,481,1755,3.6,14,6073,47,2013
Cowboys,586,375,64,7.2,4226,33,12,336,1504,4.5,12,5730,45,2013
Steelers,586,377,64.3,7.4,4306,28,14,394,1383,3.5,9,5689,37,2013
Colts,582,350,60.1,6.8,3952,23,10,409,1743,4.3,15,5695,38,2013
Bears,579,373,64.4,7.7,4450,32,13,404,1828,4.5,13,6278,45,2013
Cardinals,574,363,63.2,7.5,4291,24,22,422,1540,3.6,12,5831,36,2013
Packers,570,366,64.2,8,4538,25,16,459,2136,4.6,17,6674,42,2013
Giants,567,325,57.3,6.8,3875,18,29,381,1332,3.5,11,5207,29,2013
Chiefs,546,333,61,6.5,3561,24,8,442,2056,4.6,17,5617,41,2013
Vikings,546,325,59.5,6.7,3645,18,19,423,2081,4.9,23,5726,41,2013
Chargers,544,378,69.5,8.2,4478,32,11,486,1965,4,9,6443,41,2013
Titans,533,328,61.5,7,3710,22,16,462,1894,4.1,16,5604,38,2013
Bills,522,299,57.3,6.5,3373,16,15,546,2307,4.2,15,5680,31,2013
Raiders,519,298,57.4,7,3629,17,20,437,2000,4.6,16,5629,33,2013
Buccaneers,514,291,56.6,6.2,3181,22,12,420,1612,3.8,6,4793,28,2013
Eagles,508,310,61,8.7,4406,32,9,500,2566,5.1,19,6972,51,2013
Rams,506,301,59.5,6.6,3360,22,11,426,1752,4.1,10,5112,32,2013
Jets,480,266,55.4,6.8,3270,13,22,493,2158,4.4,12,5428,25,2013
Panthers,473,292,61.7,7.1,3379,24,13,483,2026,4.2,14,5405,38,2013
Seahawks,420,267,63.6,8.4,3508,27,9,509,2188,4.3,14,5696,41,2013
Niners,417,244,58.5,7.7,3210,21,8,505,2201,4.4,18,5411,39,2013
